11111111
10000001
10101011
1P100C01
100000E1
11111111