1111111111111
1000000000001
10000P00C0001
111C0001100C1
11C00001100C1
10000000000E1
1111111111111
