111111111111111111111111111111
1P100C000000000C00000011001101
100011000000010000000000001101
10000100000000000C000000011001
1E0C00000000000000000000000001
100000110111011101110000000001
10000001000100C100010000C00001
100000010111011100010000000001
100000010001000100010000000001
100000010111011100010000C00001
100000000000000000000000000001
10000C0000000000000000000000E1
111111111111111111111111111111